Amber	Anchor	Acres
Blue	Apple	Arbor
Bright	Autumn	Avenue
Broad	Barn	Bank
Burning	Beacon	Bend
Cinder	Bear	Canyon
Clear	Berry	Chase
Colonial	Blossom	Circle
Cotton	Bluff	Corner
Cozy	Branch	Court
Crystal	Brook	Cove
Dewy	Butterfly	Crest
Dusty	Cider	Dale
Easy	Cloud	Dell
Emerald	Creek	Edge
Fallen	Dale	Estates
Foggy	Deer	Falls
Gentle	Elk	Farms
Golden	Embers	Gardens
Grand	Fawn	Gate
Green	Forest	Glade
Harvest	Fox	Glen
Hazy	Gate	Grove
Heather	Goose	Highlands
Hidden	Grove	Hollow
High	Hickory	Isle
Honey	Hills	Jetty
Indian	Horse	Knoll
Iron	Island	Landing
Jagged	Lagoon	Lane
Lazy	Lake	Ledge
Little	Leaf	Manor
Lost	Log	Meadow
Merry	Mountain	Mews
Middle	Nectar	Nook
Misty	Oak	Orchard
Noble	Panda	Park
Old	Pine	Path
Pleasant	Pioneer	Pike
Quaking	Pond	Place
Quiet	Pony	Point
Red	Prairie	Promenade
Rocky	Quail	Ridge
Round	Rabbit	Round
Rustic	Rise	Run
Shady	River	Stead
Silent	Robin	Swale
Silver	Shadow	Terrace
Sleepy	Sky	Trace
Stony	Spring	Trail
Sunny	Timber	Vale
Tawny	Treasure	Valley
Thunder	View	View
Umber	Wagon	Vista
Velvet	Willow	Way
Wishing	Zephyr	Woods
